####################
#A#   ##   #      B #
# # # #  # #  # #   #
# # # ##    # #  # # #
# #   ## #  # # ##   #
# # #   ## # ##  ##  #
# # # # ###      ## # 
# # #   ##  # #   #  #
# #    ##   ## # ##  #
# # ## # ### #    #  #
# #  # # #  ### ## # #
# #    ##  ##    #   #
# # #   ##   ## # ## #
# #  # #   # #   # # #
# ## ## ## # ## # #  #
#    #  #    #  #    #
####################
