##############################
#A   #         # #         B#
### # # # # ### # # ### # ###
#     #   # # # #   # # #   #
# ### # # # # ##### # # ### #
#   #   # # #   #   # #   # #
### # ##### ### # ### ##### #
#   #   # #   # #   # #   # #
# ### # # # # ### # # # ### #
#     #   # #   # #   #     #
##### ### # ### # ### # #####
#   #   # #     # #   # #   #
# ### # ### # ##### ### # ###
#   #     # # #     #   #   #
# # # ##### # # ### ### ### #
#   #   #   #   #   #   #   #
# # ### ### # ### ### # #####
# #       #   #   # #       #
# ####### # ### ### # ##### #
#       # # #     # #     # #
##### # ### # ##### # ##### #
#   # #     # #   #   #     #
# ### # ##### # ### ##### # #
#   #       #   # #       # #
# ######### ### # # ##### # #
#       #   #   #   #   #   #
##############################
